0 0 0 0 0 0 0 0 0 0 
0 0 0 7 5 4 0 0 0 0 
0 0 0 5 5 5 0 0 0 0 
4 0 2 2 0 0 0 0 5 0 
4 0 2 2 4 4 5 5 5 0 
4 4 6 6 7 4 5 5 5 0 
0 6 6 7 7 4 5 6 0 0 
0 3 3 7 6 6 5 6 6 0 
0 3 5 6 6 5 5 5 6 0 
0 3 5 5 5 5 5 0 0 0 
0 3 5 6 6 5 4 0 0 0 
0 3 6 6 4 4 4 0 3 0 
3 3 1 1 1 1 5 0 3 0 
3 3 4 4 4 5 5 3 3 0 
3 6 4 5 5 5 5 7 7 0 
3 3 4 4 4 5 5 5 3 0 
5 3 2 2 3 5 5 5 3 0 
5 5 2 2 3 5 5 3 3 0 
5 2 2 3 3 5 5 5 7 0 
5 0 6 6 3 7 7 5 6 6 
