0 0 0 1 1 1 1 0 0 0 
0 0 0 7 7 2 4 0 0 0 
0 0 0 3 7 7 4 0 0 0 
0 0 0 5 5 5 0 0 0 0 
0 0 0 0 2 2 0 0 0 0 
0 0 0 0 2 2 0 0 0 0 
0 0 0 1 1 1 1 0 0 0 
0 0 0 7 7 0 0 0 0 0 
0 0 0 0 7 7 0 0 0 0 
0 0 0 7 7 0 0 0 0 0 
0 0 0 0 7 7 0 0 0 0 
0 0 0 0 5 0 0 0 0 0 
0 0 0 5 5 5 0 0 0 0 
0 0 0 0 5 0 0 0 0 0 
0 0 0 5 5 5 0 0 0 0 
0 0 0 0 0 6 6 0 0 0 
0 0 0 0 6 6 0 0 0 0 
0 0 0 7 7 0 0 0 0 0 
0 0 0 0 7 7 0 0 1 1 
0 0 0 4 2 2 6 0 1 1 
