0 0 0 0 0 0 0 0 0 0 
0 0 0 0 0 0 0 0 0 0 
0 0 0 0 0 0 0 0 0 0 
0 0 0 0 0 0 0 0 0 0 
0 0 0 0 0 0 0 0 0 0 
0 0 0 0 0 0 0 0 0 0 
0 0 0 0 0 0 0 0 0 0 
0 0 0 0 0 0 0 0 0 0 
0 0 0 0 0 0 0 0 0 0 
0 0 0 0 2 2 0 0 0 0 
0 0 0 3 2 2 0 0 0 0 
0 0 0 3 3 3 4 0 0 0 
0 0 0 0 4 4 4 0 0 0 
0 0 0 0 0 6 6 0 0 0 
0 0 0 0 6 6 0 0 0 0 
0 0 0 0 5 0 3 3 4 0 
0 0 0 5 5 5 3 0 4 0 
0 0 0 0 5 0 3 0 4 4 
0 5 0 5 5 5 4 0 2 2 
5 5 5 0 4 4 4 0 2 2 
