0 0 0 0 0 0 0 0 0 0 
0 0 0 0 0 0 0 0 0 0 
0 0 0 0 0 0 0 0 0 0 
0 0 0 0 0 0 0 0 0 0 
0 0 0 0 0 0 0 0 0 0 
0 0 0 0 0 0 0 0 0 0 
0 0 0 0 0 0 0 0 0 0 
0 0 0 0 0 0 0 0 0 0 
0 0 0 0 0 0 0 0 0 0 
0 0 0 0 0 0 0 0 0 0 
0 0 0 0 0 0 0 0 0 0 
0 0 0 0 0 0 0 0 0 7 
0 0 0 0 0 0 0 0 7 7 
0 0 0 0 0 0 0 0 7 5 
0 0 0 0 0 0 0 0 5 5 
0 3 3 0 0 0 0 0 6 5 
0 3 3 3 7 0 0 7 6 6 
0 3 3 7 7 0 7 7 0 6 
1 4 3 7 4 4 7 0 0 1 
1 4 3 3 3 4 6 0 1 1 
